12:12
0 0 17 0 0 0 0 0 0 0 63 
0 0 0 0 0 0 0 0 0 0 0 0
0 0 17 0 0 0 0 0 0 0 64 0
0 0 0 0 0 0 0 0 0 0 0 0
0 0 0 0 0 0 0 0 0 0 0 0
0 0 0 50 0 0 0 17 0 0 0 0
0 0 0 0 0 0 0 0 0 17 0 0
0 0 17 0 0 0 0 0 0 0 0 0
0 0 17 0 0 0 0 0 0 32 0 0
0 0 17 0 0 0 0 0 0 32 0 0
0 0 17 0 0 0 0 0 0 32 0 0
0 0 17 0 0 0 0 0 0 32 0 0


