12:12
0 0 0 0 0 0 38 34 32 0 0 0
0 0 0 0	0 37 58 32 0 0 0 0
0 0 0 0	0 33 37 32 0 0 0 0
0 0 0 17 0 0 0 0 0 0 0 0
0 18 0 0 0 0 0 0 0 0 0 0
0 0 0 0	0 0 0 0	0 0 0 0
0 0 0 0	0 0 0 0	0 17 0 0
0 0 0 0	18 0 0 18 0 0 0 0
0 0 0 0	0 0 0 0	0 0 0 0
0 0 0 0	0 0 17 0 0 0 0 0
0 55 0 0 0 0 0 0 0 0 0 0
0 0 0 0	0 0 0 0	0 0 0 0

