12:12
0 0 0 0 0 0 0 0 0 0 0 0
0 0 0 0	0 0 0 0	18 0 0 0
0 0 0 0	32 32 0 0 0 0 0 53
0 0 0 32 0 0 32 0 0 0 0 0
0 0 0 0	0 0 0 35 0 0 0 0
0 0 18 0 0 0 0 0 37 0 0 0
0 0 0 0	0 0 0 320 0 0 0
0 0 0 0	0 0 0 0	17 0 0 0
0 0 0 0	0 0 0 0	0 0 0 0
0 0 0 18 0 0 0 0 0 0 0 0
0 56 0 0 0 0 0 18 0 0 0 0
0 0 0 64 0 0 0 18 0 0 0 0

