12:12
0 64 0 0 0 0 0 0 0 0 0 0
0 0 0 0	0 0 0 0	57 0 0 0
0 0 0 0	64 0 0 0 0 0 0 0
0 0 0 0	0 0 0 0	0 0 0 0
0 0 0 17 17 17 17 17 17 0 0 0
0 0 0 0	0 0 0 0	0 17 0 0
0 0 0 0	17 17 0 0 17 0 0 0
0 0 0 17 60 17 0 0 17 0 0 0
0 0 0 17 0 0 17 0 17 0 0 0
0 0 0 17 0 0 0 0 0 17 0 0
0 0 0 17 17 17 17 17 17 0 0 0
0 0 0 0	0 0 0 0	0 0 0 0

