12:12
0 0 0 0 0 51 0 0 0 0 0 0
18 17 0 0 0 0 0 0 32 0 17 0
0 0 0 0 0 0 0 0 0 0 0 0
18 17 0 0 0 0 0 0 32 0 17 0
0 0 0 0 0 0 0 0 0 0 0 0
18 17 0 0 0 0 0 0 34 0 17 0
0 0 0 0 0 0 0 0 0 0 0 0
18 17 0 0 0 0 0 0 32 0 17 0
0 0 0 0 0 0 0 0 0 0 0 0
18 17 0 0 0 0 0 0 32 0 17 0
0 0 0 0 0 54 0 0 0 0 0 0
18 17 0 0 0 0 0 0 32 0 17 0

